15 15
1 1
13 13
***************
*.  *   *     *
*.    *   *   *
******     *  *
*             *
* ***** ***   *
* *       *   *
* *   *****   *
*   *     *   *
***** *** *   *
*   *   * *****
*   *     *   *
* *****   * * *
*     *     * *
***************