10 10
3 1
7 8
**********
*        *
* * * * **
*   * *  *
***** ****
*     *  *
* ****** *
*        *
*** * * **
**********
